X,X,X,X,X,X,X,X,X,X,X,X,X,X,X
X,11,E,E,B,B,B,B,B,B,B,E,E,21,X
X,E,X,E,X,B,X,B,X,B,X,E,X,E,X
X,E,E,B,B,B,B,B,B,B,B,B,E,E,X
X,B,X,B,X,B,X,B,X,B,X,B,X,B,X
X,B,B,B,B,B,B,B,B,B,B,B,B,B,X
X,B,X,B,X,B,X,B,X,B,X,B,X,B,X
X,B,B,B,B,B,B,B,B,B,B,B,B,B,X
X,B,X,B,X,B,X,B,X,B,X,B,X,B,X
X,B,B,B,B,B,B,B,B,B,B,B,B,B,X
X,B,X,B,X,B,X,B,X,B,X,B,X,B,X
X,E,E,B,B,B,B,B,B,B,B,B,E,E,X
X,E,X,E,X,B,X,B,X,B,X,E,X,E,X
X,31,E,E,B,B,B,B,B,B,B,E,E,41,X
X,X,X,X,X,X,X,X,X,X,X,X,X,X,X
